************************************************************************
#                                                                      #
#                                                                      #
#     +     +  +  ++++++  +++++++  +++++++  +++++++  +     +           #
#      +   +   +  +          +     +     +  +++++++    + +             #
#       + +    +  +          +     +     +  +    +      +              #
#        +     +  ++++++     +     +++++++  +     +     +              #
#                                                                      #
#            +++++++ +    +  ++++++                                    #
#               +    ++++++  +++                                       #
#               +    +    +  +                                         #
#               +    +    +  ++++++                                    #
#                                    ++++++  +    +  +++++             #
#                                    +++     + +  +  +    +            #
#                                    +       +  + +  +    +            #
#                                    ++++++  +   ++  +++++             #
#                                                                      #
************************************************************************