************************************************************************
#                                                                      #
#                                                                      #
#       $           $     $$$$$$$$$$$$$$             $$                #
#       $$          $     $            $            $ $                #
#       $ $         $     $            $           $  $                #
#       $  $        $     $            $          $   $                #
#       $   $       $     $            $         $    $                #
#       $    $      $     $            $        $     $                #
#       $     $     $     $            $       $      $                #
#       $      $    $     $            $              $                #
#       $       $   $     $            $              $                #
#       $        $  $     $            $              $                #
#       $         $ $     $            $  $$$         $                #
#       $          $$     $$$$$$$$$$$$$$  $$$         $                #
#                                                                      #
#                                                                      #
************************************************************************