#################################################
#@      i                                       #
#           e                R                  #
#    i                                          #
# i                                             #
#                                               #
#                                        e      #
#                                               #
#################################################