########################
#@                     #
#           e          #
#                      #
#                      #
#     e                #
#             e        #
#                      #
#                      #
#                      #
#                      #
#  R                   #
#                      #
#               i      #
#                      #
#                      #
#                      #
########################