##########
#@      2#
#        #
#    1   #
#        #
##########