##########
#@      i#
#        #
#    i   #
#        #
##########