#################################################
#@      i                                       #
#           e                                   #
#    i                                          #
# i                                             #
#                                               #
#                                               #
#                                               #
#################################################