##########
#@      i#
#        #
#    i   #
# i      #
##########