#################
#@      i       #
#           e   #
#    i          #
# i             #
#################