##########
#@       #
#        #
#    1   #
#        #
##########